......................................................................S......................................................................
......................................................................^......................................................................
.............................................................................................................................................
.....................................................................^.^.....................................................................
.............................................................................................................................................
....................................................................^.^.^....................................................................
.............................................................................................................................................
...................................................................^.^...^...................................................................
.............................................................................................................................................
..................................................................^.....^.^..................................................................
.............................................................................................................................................
.................................................................^.^...^.^.^.................................................................
.............................................................................................................................................
................................................................^.^...^.^...^................................................................
.............................................................................................................................................
...............................................................^...^.....^...^...............................................................
.............................................................................................................................................
..............................................................^...^.....^.^.^.^..............................................................
.............................................................................................................................................
.............................................................^.^.....^.^.^.....^.............................................................
.............................................................................................................................................
............................................................^.^.^.....^.^.^...^.^............................................................
.............................................................................................................................................
...........................................................^.......^.^.^.^.^...^.^...........................................................
.............................................................................................................................................
..........................................................^.......^.^.^...^...^.^.^..........................................................
.............................................................................................................................................
.........................................................^.^...^.^...^.....^.^.^.^.^.........................................................
.............................................................................................................................................
........................................................^.^...^.^.^.^.^...^.^.....^.^........................................................
.............................................................................................................................................
.......................................................^.^.^.^.^.^.^.....^.^.^.....^.^.......................................................
.............................................................................................................................................
......................................................^.^.^...^.^.^.^...^.^.^.^.^.....^......................................................
.............................................................................................................................................
.....................................................^...............^.^.^.....^.......^.....................................................
.............................................................................................................................................
....................................................^.^.............^.^.^.^.....^.^...^.^....................................................
.............................................................................................................................................
...................................................^.^...^.^.^.^.^.^.^.^.^.^.^.^.....^.^.^...................................................
.............................................................................................................................................
..................................................^.^.^.^.^.^.^...^.^.^...^.^.^.^.....^.^.^..................................................
.............................................................................................................................................
.................................................^.^...^.^.^.^.....^.^.^...^.^.^...^...^.^.^.................................................
.............................................................................................................................................
................................................^...^...^.^...^.^.^.^.^.^.....^.^...^.^...^.^................................................
.............................................................................................................................................
...............................................^.....^.....^.^.^...^.^.^.^.......^.^.^.......^...............................................
.............................................................................................................................................
..............................................^.^...^.^...^.^...^...^.^.....^...^.^.^.......^.^..............................................
.............................................................................................................................................
.............................................^.^.^.^...^.^.....^.^.^.^.^...^.^.^.^.^.^...^...^.^.............................................
.............................................................................................................................................
............................................^.^.^.^...^.......^.^.^...^.^.^.^.^.^...^.^.^...^.^.^............................................
.............................................................................................................................................
...........................................^.^.^...^...^...^.^.^.^.^.^.....^...^.^.....^.^.....^.^...........................................
.............................................................................................................................................
..........................................^.....^.......^.^.^.^.^.....^...^.^.^.^.^...^.^.........^..........................................
.............................................................................................................................................
.........................................^.^...^.....^.^...^.^.^.....^.^.^.......^.....^.^...^...^.^.........................................
.............................................................................................................................................
........................................^.^...^.^.^.^.^.^.^.......^.^.^...^.......^...^.^...^.^...^.^........................................
.............................................................................................................................................
.......................................^...^...^.^.^.^...........^.^.^.^.^.^.^...^.^.....^...^.^...^.^.......................................
.............................................................................................................................................
......................................^.^...^.^.^...^.^.......^.........^...^...^.^.....^...^.^.^.^...^......................................
.............................................................................................................................................
.....................................^.^.^.^.^.^.......^.^.^...^.......^...^.^...^...^.^...^.^.^.^.^...^.....................................
.............................................................................................................................................
....................................^.^.^...^.^.^.^...^.....^...^.^.^.^.^.^.^.....^.^.^.........^.....^.^....................................
.............................................................................................................................................
...................................^.^.^.^.....^.^.^.^.^...^...^.^.^.....^...^.......^.^.^.....^.^...^.^.^...................................
.............................................................................................................................................
..................................^...^.^.^.....^.^...^...^.^...^.^.^...^...^...^.......^.....^.^.^...^.^.^..................................
.............................................................................................................................................
.................................^.^...^.^.^...^.^...^.^.........^.^.^.^.^.^.^.^.^.......^.....^.^.^.^.^.^.^.................................
.............................................................................................................................................
................................^...^.^.^.^.^.^.^.^.^.........^.^.........^...^.^...^...^.....^.^.....^...^.^................................
.............................................................................................................................................
...............................^.^.^.^...^.^.........^...^.^.^.............^.^...^.^.^.^.^...^.^.^.....^.^.^.^...............................
.............................................................................................................................................
..............................^.^.^.^...^.^.^...........^.^.^.......^.^.^.^.^...^.......^.^.^.^.^...^.^.....^.^..............................
.............................................................................................................................................
.............................^.^...^...^.........^.........^.^.^.^.^.^.^.^...^...^.....^.^.^.^.....^.^.....^...^.............................
.............................................................................................................................................
............................^.^.^.^...^.........^.^.......^...^.^.^...^.^.^.^.^...^...^.^.........^.^...^.^.^.^.^............................
.............................................................................................................................................
...........................^.^.^.^...^.^.^.^.^.^.^.^...^.^...^.^...^.^.^...^...^.^.^.^.^.^.....^...^.^.^.^.^.^...^...........................
.............................................................................................................................................
..........................^.....^.^.^.....^.^.......^.^...^...^.^.^...^.....^.^.^...^...^.^...^.^.^.^.^.^...^.^...^..........................
.............................................................................................................................................
.........................^.^.....^.......^.^.^.....^.^.^.^.^.^.^.^.^.^.^.^.^.....^.^...^.^.....^.^...^.....^.^...^.^.........................
.............................................................................................................................................
........................^...^...^.^.....^...........^.^...^.^.....^.^...^...^...^.....^.^.....^.^.^.........^.^...^.^........................
.............................................................................................................................................
.......................^.^.^.^...^.......^...........^.^.^.......^.^.^.^.......^.^...^...^.^.....^.^...^...^.^.^.^...^.......................
.............................................................................................................................................
......................^.^.^...........^...^.^.^.....^.^.^.^...^.^.^...^.^.^...^.^.^.^.^.^...^...^...^.^.^.^.^.^.^.^...^......................
.............................................................................................................................................
.....................^...^.....^...^.....^...^.^...^.^.^...^.^.^...^.......^.^.^.^.^.^.^.^.^...^.^.....^...^.^.....^.^.^.....................
.............................................................................................................................................
....................^.^.^.^...^.^.^.^...^...^.^.^...^.....^...^...^.^.....^.^.^...^.^.^.^.....^.^.^.......^...^...^.^...^....................
.............................................................................................................................................
...................^.......^.....^.^.^.^.^.^...^.^...^...^.....^...^...^.^.^.......^.^.^.......^...^.^.......^.^.^...^.^.^...................
.............................................................................................................................................
..................^.^.......^...^.^...^.^...^.^.^...^.^.^...^.^.....^.^.^.^.^.....^...^.^.^.^.^.^.^.^.^.........^.^.....^.^..................
.............................................................................................................................................
.................^.^.^.^.^.^.^.^...^.^.^...^...^.^...^.^.^.^.^.^.^.^...^.^.^.^.^.^.^.....^.....^.....^.^...^...^.^.^.....^.^.................
.............................................................................................................................................
................^.^...^.^.....^.^...^.^.^.....^...^...^.........^.^.^.^.^...^.^.^.^.....^.^.....^.......^.^.^.^.^.....^.^...^................
.............................................................................................................................................
...............^.^.....^.^...^.^...^.^.......^.^.^.^...^.........^...^.^.^.^.^.^...^...^.^...^.^.^.^...^.^...^.^.^...^.^.^.^.^...............
.............................................................................................................................................
..............^.^.....^.^.^...^.^.^.^.....^.^.....^.^.^.^.^.^.^.^.^.^...^...^.^...^.^.......^...^.......^...^.^.....^.^.^...^.^..............
.............................................................................................................................................
.............^.^.^.^...^.....^.^.^.^.^...^...........^...^.^.^.^.....^.^.^.^.^...^...^.......^.^.^.......^.^...^.....^...^.....^.............
.............................................................................................................................................
............^.....^.^.^.^...^...^...^.^.^.....^.....^.^.^.^.^.^.^.....^.^.^.^.^.^...^.^.^.^...^.^...^.....^.....^.^.....^.^...^.^............
.............................................................................................................................................
...........^.^...^.^...^.^...^.^.^.....^.^.^.^...^.....^.^...^.....^.^.^...^.^.^...^.^.^.^.^.^.....^.^.^.^.^.^.^.^.^...^.^.^.^...^...........
.............................................................................................................................................
..........^.^.......^.^.^.....^...^.....^.^.^.^...^...^.^...^.^...^...^.^.^.^.^.^.^.^.^.^.^.......^.^.^...^.^.^.^.^.....^.^.^...^.^..........
.............................................................................................................................................
.........^.^.........^.^.^.^.^.^...^.....^.^.^.^.^.....^.^.^.^.^...^.......^...^.^.^.....^.^...^.^.^.^.^.^.^.....^.^...........^...^.........
.............................................................................................................................................
........^...^.......^.^.^.....^.^.^.^.^.^.^...^.........^.^.^.^...........^.........^...^...^.^...^.^.....^.......^...^.........^...^........
.............................................................................................................................................
.......^...^.^.....^...^.^...^...^...^.^.^...^.^.......^...^.^.^.^.......^.^.......^.^.^...^...^.^.^.....^.^...^.^.^.^.^.^...^...^...^.......
.............................................................................................................................................
......^.......^.......^.^.^.^.^.^...^.^...^.....^.....^.^.^.^.^...^.^...^.^.^...^.^.^.^.^...^.^.^.^.^.^.^.^.^.^.^...^.^.....^.^.^.^.^.^......
.............................................................................................................................................
.....^.^.....^.^.......^.........^.^.^.^.^.^.....^.^...^.^.^...^.....^...^.......^.^.^.^.^.......^.^.....^.^.^.^...^.^.^.....^.^.......^.....
.............................................................................................................................................
....^.^.^.^...^.^.^.^.^.^.......^.^.^.....^.....^...^.^.^.^.^.^.....^.^.......^.^...^.^.^.^.....^.^.........^.^.......^.^...^.^.^.....^.^....
.............................................................................................................................................
...^.^.^.^.^.^.^...^...^.....^.^.^...^...^.^...^.^.^.....^.^...^...^.^.^...^...^.^...^.....^.^.^.^.^.^.^...^.^...^.........^.^...^.^...^.^...
.............................................................................................................................................
..^.^.^.^.^.^.^.^.......^...^.....^.^...^.^.^.^.^.^.^.....^.....^.^.^.^...^.^.^.^...^.....^.^.^.^.^.^.^.......^.^.^.......^...^.^.^...^...^..
.............................................................................................................................................
.^.^...^...^.^.^.^.....^.^.^.^.....^.^...^.^.^...^.^.^.^.^.....^.^.......^.....^.....^...^...^.^.^.^.^.........^.^...^.^.^.^.^.^.^...^.^...^.
.............................................................................................................................................
.............................................................................................................................................